Animals - חיות
Mammal - יונק
Reptile - זוחל
Bird - עוף
Fish - דג
Amphibian - יוצא מן הכלל
Insect - חרק
Mammals - יונקים
Elephant - פיל
Lion - אריה
Tiger - טיגריס
Giraffe - ג'ירף
Bear - דב
Monkey - קוף
Dog - כלב
Cat - חתול
Rabbit - ארנבון
Mouse - עכבר
Snake - נחש
Turtle - צב
Frog - צפרדע
Butterfly - פרפר
Bee - דבורה
Ant - נמלה
Spider - עכבר עצם
Shark - כריש
Dolphin - דולפין
Whale - לוויתן
Octopus - תמנון
Penguin - פנגווין
Ostrich - יער
Kangaroo - קנגרו
Horse - סוס
Cow - פר
Sheep - כבש
Goat - עז
Chicken - תרנגול
Duck - ברווז
