Animals - Zwierzęta
Mammal - Ssak
Reptile - Gad
Bird - Ptak
Fish - Ryba
Amphibian - Płaz
Insect - Owad
Mammals - Ssaki
Elephant - Słoń
Lion - Lew
Tiger - Tygrys
Giraffe - Żyrafa
Bear - Niedźwiedź
Monkey - Małpa
Dog - Pies
Cat - Kot
Rabbit - Królik
Mouse - Mysz
Snake - Wąż
Turtle - Żółw
Frog - Żaba
Butterfly - Motyl
Bee - Pszczoła
Ant - Mrówka
Spider - Pająk
Shark - Rekin
Dolphin - Delfin
Whale - Wieloryb
Octopus - Ośmiornica
Penguin - Pingwin
Ostrich - Struś
Kangaroo - Kangur
Horse - Koń
Cow - Krowa
Sheep - Owca
Goat - Koza
Chicken - Kurczak
Duck - Kaczka
