Clothing - בגדים
Shirt - חולצה
Blouse - בלוזה
T-shirt - חולצת טי-שירט
Sweater - סוודר
Jacket - ז'קט
Coat - מעיל
Dress - שמלה
Skirt - חצאית
Pants/Trousers - מכנסיים
Jeans - ג'ינס
Shorts - שורט
Hat - כובע
Cap - כובע
Scarf - צעיף
Gloves - כפפות
Socks - גרביים
Shoes - נעליים
Boots - מגפיים
Sandals - סנדלים
Slippers - כפכפים
Belt - חגורה
Tie - עניבה
Bow tie - עניבת קשת
Suit - חליפה
Tuxedo - חליפת ערב
Pajamas - פיג'מות
Underwear - הלבשה תחתונה
Swimsuit - בגד ים
Bikini - ביקיני
Raincoat - מעיל גשם
Umbrella - מטריה
