Emotions - Emotionen
Feelings - Gefühle
Happy - Glücklich
Sad - Traurig
Angry - Wütend
Surprised - Überrascht
Excited - Aufgeregt
Nervous - Nervös
Relaxed - Entspannt
Content - Zufrieden
Bored - Gelangweilt
Stressed - Gestresst
Confused - Verwirrt
Frustrated - Frustrsiert
Proud - Stolz
Embarrassed - Verlegen
Grateful - Dankbar
Loved - Geliebt
Lonely - Einsam
Hopeful - Hoffnungsvoll
Calm - Ruhig
Enthusiastic - Enthusiastisch
Jealous - Eifersüchtig
Guilt - Schuld
Shame - Scham
Fear - Angst
Anxiety - Angstgefühl
Happiness - Glück
Sadness - Traurigkeit
Anger - Wut
Joy - Freude
Love - Liebe
Hate - Hass
Disgust - Ekel
Surprise - Überraschung
Pain - Schmerz
Pleasure - Vergnügen
Satisfaction - Zufriedenheit
