Emotions - רגשות
Feelings - תחושות
Happy - שמח
Sad - עצוב
Angry - כועס
Surprised - מפתיע
Excited - מתרגש
Nervous - עצבני / מתוח / לחוץ
Relaxed - רגוע
Bored - משועמם
Stressed - לחוץ
Confused - מבולבל
Frustrated - מתוסכל
Proud - גאה
Embarrassed - מבושה
Grateful - אסיר תודה
Loved - אהוב
Lonely - בודד
Hopeful - מלא תקווה
Calm - רגוע
Enthusiastic - מתרגש
Jealous - קנאי
Guilt - אשמה
Shame - בושה
Fear - פחד
Anxiety - חרדה
Happiness - אושר
Sadness - עצב
Anger - כעס
Joy - שמחה
Love - אהבה
Hate - שנאה
Disgust - געל
Surprise - הפתעה
Pain - כאב
Pleasure - הנאה
Satisfaction - שביעות רצון
