Emotions - Emocje
Feelings - Uczucia
Happy - Szczęśliwy
Sad - Smutny
Angry - Zły
Surprised - Zaskoczony
Excited - Podekscytowany
Nervous - Nerwowy
Relaxed - Zrelaksowany
Content - Zadowolony
Bored - Znudzony
Stressed - Zestresowany
Confused - Zdezorientowany
Frustrated - Sfrustrowany
Proud - Dumny
Embarrassed - Zakłopotany
Grateful - Wdzięczny
Loved - Kochany
Lonely - Samotny
Hopeful - Pełen nadziei
Calm - Spokojny
Enthusiastic - Entuzjastyczny
Jealous - Zazdrosny
Guilt - Wina
Shame - Wstyd
Fear - Strach
Anxiety - Niepokój
Happiness - Szczęście
Sadness - Smutek
Anger - Złość
Joy - Radość
Love - Miłość
Hate - Nienawiść
Disgust - Obrzydzenie
Surprise - Zaskoczenie
Pain - Ból
Pleasure - Przyjemność
Satisfaction - Satysfakcja
