Emotions - Эмоции
Feelings - Чувства
Happy - Счастливый
Sad - Грустный
Angry - Злой
Surprised - Удивленный
Excited - Возбужденный
Nervous - Нервный
Relaxed - Расслабленный
Content - Удовлетворенный
Bored - Скучающий
Stressed - Напряженный
Confused - Смущенный
Frustrated - Разочарованный
Proud - Гордый
Embarrassed - Смущенный
Grateful - Благодарный
Loved - Влюбленный
Lonely - Одинокий
Hopeful - Надеющийся
Calm - Спокойный
Enthusiastic - Восторженный
Jealous - Ревнивый
Guilt - Вина
Shame - Стыд
Fear - Страх
Anxiety - Тревога
Happiness - Счастье
Sadness - Грусть
Anger - Злость
Joy - Радость
Love - Любовь
Hate - Ненависть
Disgust - Отвращение
Surprise - Удивление
Pain - Боль
Pleasure - Удовольствие
Satisfaction - Удовлетворение
