Food - Essen
Meal - Mahlzeit
Breakfast - Frühstück
Lunch - Mittagessen
Dinner - Abendessen
Snack - Snack
Appetizer - Vorspeise
Main course - Hauptgang
Dessert - Nachtisch
Beverage - Getränk
Water - Wasser
Juice - Saft
Tea - Tee
Coffee - Kaffee
Milk - Milch
Bread - Brot
Rice - Reis
Pasta - Pasta
Meat - Fleisch
Chicken - Hühnchen
Fish - Fisch
Vegetables - Gemüse
Fruits - Früchte
Salad - Salat
Sandwich - Sandwich
Pizza - Pizza
Burger - Burger
Fries - Pommes
Soup - Suppe
Cheese - Käse
Eggs - Eier
Butter - Butter
Sugar - Zucker
Salt - Salz
Pepper - Pfeffer
Spices - Gewürze
Olive oil - Olivenöl
Vinegar - Essig
Honey - Honig
Jam - Marmelade
Ketchup - Ketchup
Mustard - Senf
Mayonnaise - Mayonnaise
