Health - Gesundheit
Wellness - Gesundheit
Exercise - Übung
Workout - Training
Fitness - Fitness
Nutrition - Ernährung
Healthy - Gesund
Unhealthy - Ungesund
Diet - Diät
Weight - Gewicht
Stress - Stress
Relaxation - Entspannung
Mental health - Psychische Gesundheit
Physical health - Körperliche Gesundheit
Sleep - Schlaf
Rest - Ruhe
Energy - Energie
Vitamins - Vitamine
Hydration - Hydratation
Medicine - Medizin
Doctor - Arzt
Nurse - Krankenschwester
Hospital - Krankenhaus
Appointment - Termin
Check-up - Untersuchung
Therapist - Therapeut
Massage - Massage
Yoga - Yoga
Meditation - Meditation
Gym - Fitnessstudio
Sickness - Krankheit
Pain - Schmerz
Allergy - Allergie
Flu - Grippe
Cold - Erkältung
Headache - Kopfschmerzen
Heart - Herz
Lungs - Lungen
Stomach - Magen
Back - Rücken
Leg - Bein
Arm - Arm
Hand - Hand
Foot - Fuß