Animals - Тварини
Mammal - Ссавець
Reptile - Плазун
Bird - Птах
Fish - Риба
Amphibian - Земноводний
Insect - Комаха
Mammals - Ссавці
Elephant - Слон
Lion - Лев
Tiger - Тигр
Giraffe - Жираф
Bear - Ведмідь
Monkey - Мавпа
Dog - Собака
Cat - Кіт
Rabbit - Кролик
Mouse - Миша
Snake - Змія
Turtle - Черепаха
Frog - Жаба
Butterfly - Метелик
Bee - Бджола
Ant - Мураха
Spider - Павук
Shark - Акула
Dolphin - Дельфін
Whale - Кит
Octopus - Восьминіг
Penguin - Пінгвін
Ostrich - Страус
Kangaroo - Кенгуру
Horse - Кінь
Cow - Корова
Sheep - Вівця
Goat - Коза
Chicken - Курка
Duck - Качка
