Animals - Животные
Mammal - Млекопитающее
Reptile - Пресмыкающееся
Bird - Птица
Fish - Рыба
Amphibian - Земноводное
Insect - Насекомое
Mammals - Млекопитающие
Elephant - Слон
Lion - Лев
Tiger - Тигр
Giraffe - Жираф
Bear - Медведь
Monkey - Обезьяна
Dog - Собака
Cat - Кошка
Rabbit - Кролик
Mouse - Мышь
Snake - Змея
Turtle - Черепаха
Frog - Лягушка
Butterfly - Бабочка
Bee - Пчела
Ant - Муравей
Spider - Паук
Shark - Акула
Dolphin - Дельфин
Whale - Кит
Octopus - Осьминог
Penguin - Пингвин
Ostrich - Страус
Kangaroo - Кенгуру
Horse - Лошадь
Cow - Корова
Sheep - Овца
Goat - Козел
Chicken - Курица
Duck - Утка
