Animals - Tiere
Mammal - Säugetier
Reptile - Reptil
Bird - Vogel
Fish - Fisch
Amphibian - Amphibie
Insect - Insekt
Mammals - Säugetiere
Elephant - Elefant
Lion - Löwe
Tiger - Tiger
Giraffe - Giraffe
Bear - Bär
Monkey - Affe
Dog - Hund
Cat - Katze
Rabbit - Hase
Mouse - Maus
Snake - Schlange
Turtle - Schildkröte
Frog - Frosch
Butterfly - Schmetterling
Bee - Biene
Ant - Ameise
Spider - Spinne
Shark - Hai
Dolphin - Delfin
Whale - Wal
Octopus - Krake
Penguin - Pinguin
Ostrich - Strauß
Kangaroo - Känguru
Horse - Pferd
Cow - Kuh
Sheep - Schaf
Goat - Ziege
Chicken - Huhn
Duck - Ente
