Clothing - קליידונג
Shirt - העמד
Blouse - בלוז
T-shirt - טי־שירט
Sweater - פּולאָווער
Jacket - זשאַקעט
Coat - מענטל
Dress - קלייד
Skirt - רוק
Pants/Trousers - הויזן
Jeans - דזשינס
Shorts - קורץ
Hat - הוט
Cap - קאַפּ
Scarf - טוך
Gloves - הנט
Socks - שטרימפּעל
Shoes - שוה
Boots - שטיפּן
Sandals - סאַנדאַליש
Slippers - פּאָוזן
Belt - גורדל
Tie - קראוואט
Bow tie - שלעפּן קראוואט
Suit - קאָסטים
Tuxedo - טוקסעדאָ
Pajamas - פּיזשאַמאַס
Underwear - געזונטער
Swimsuit - באַדײן־קלייד
Bikini - ביקיני
Raincoat - פֿרישטאַל
Umbrella - פּאַראָזשוווער
