Food - Jedzenie
Meal - Posiłek
Breakfast - Śniadanie
Lunch - Obiad
Dinner - Kolacja
Snack - Przekąska
Appetizer - Przystawka
Main course - Danie główne
Dessert - Deser
Beverage - Napój
Water - Woda
Juice - Sok
Tea - Herbata
Coffee - Kawa
Milk - Mleko
Bread - Chleb
Rice - Ryż
Pasta - Makaron
Meat - Mięso
Chicken - Kurczak
Fish - Ryba
Vegetables - Warzywa
Fruits - Owoce
Salad - Sałatka
Sandwich - Kanapka
Pizza - Pizza
Burger - Burger
Fries - Frytki
Soup - Zupa
Cheese - Ser
Eggs - Jajka
Butter - Masło
Sugar - Cukier
Salt - Sól
Pepper - Pieprz
Spices - Przyprawy
Olive oil - Olej z oliwek
Vinegar - Ocet
Honey - Miód
Jam - Dżem
Ketchup - Ketchup
Mustard - Musztarda
Mayonnaise - Majonez
