Tools - כלים
Hammer - פטיש
Screwdriver - מברג
Wrench - מפתח ברגים
Pliers - צבת
Tape measure - סרט מדידה
Drill - מקדח
Saw - מסור
Nail - מסמר
Screw - בורג
Level - פלס
Chisel - מפלסת
Trowel - שפכטל
Sander - מלטשת
Saw blade - להב מסור
Clamp - הדק
Carpenter - נגר
Cordless drill - מקדח אלחוטי
Paintbrush - מברשת
Roller brush - מברשת רולר
Bucket - דלי
Sponge - ספוג
Ladder - סולם
Gloves - כפפות
Safety glasses - משקפי בטיחות
Helmet - קסדה
Stapler - שדכן
Tape - סרט הדבקה
Glue - דבק
Screwdriver set - סט מברגים
Wrench set - סט מפתחות ברגים
Toolbox - קופסת כלים
